TTT	Phenylalanine
TTC	Phenylalanine
TTA	Leucine
TTG	Leucine
TCT	Serine
TCC	Serine
TCA	Serine
TCG	Serine
TAT	Tyrosine
TAC	Tyrosine
TAA	Termination
TAG	Termination
TGT	Cysteine
TGC	Cysteine
TGA	Termination
TGG	Tryptophan
CTT	Leucine
CTC	Leucine
CTA	Leucine
CTG	Leucine
CCT	Proline
CCC	Proline
CCA	Proline
CCG	Proline
CAT	Histidine
CAC	Histidine
CAA	Glutamine
CAG	Glutamine
CGT	Arginine
CGC	Arginine
CGA	Arginine
CGG	Arginine
ATT	Isoleucine
ATC	Isoleucine
ATA	Isoleucine
ATG	Methionine
ACT	Threonine
ACC	Threonine
ACA	Threonine
ACG	Threonine
AAT	Asparagine
AAC	Asparagine
AAA	Lysine
AAG	Lysine
AGT	Serine
AGC	Serine
AGA	Arginine
AGG	Arginine
GTT	Valine
GTC	Valine
GTA	Valine
GTG	Valine
GCT	Alanine
GCC	Alanine
GCA	Alanine
GCG	Alanine
GAT	Aspartate
GAC	Aspartate
GAA	Glutamate
GAG	Glutamate
GGT	Glycine
GGC	Glycine
GGA	Glycine
GGG	Glycine